1111111111111
1001000000001
1000010111001
1P0011E000001
1110000000111
1000C11111001
1000111000001
1111111111111
1111111111111
